1111111111111111111
1000000000011110011
111000111  11000011111
1100001010011111111
100000111000111011
10000N000  11    0000000011
1111111111111111111