1111111111111111111111
1000000000111010000010000001
11100010001 100011111
110000100011100011110
10000000S00000000001111
10W00001111110000000011
11111111111111111111111111