1111111111111111111
1000000000000000011
1110001110000011111
1100001010000111111
1000001110000000011
100000000000N0000001
1000N10110000000011
1111111111111111111