NO textures/north.xpm
SO textures/south.xpm
WE textures/west.xpm
EA textures/east.xpm

F 128, 128, 128
C 135, 206, 235

1111111111111111111111
10000000000000000011
11010000111111100000111
110000101   100111000111111
100000001   110000000111111
1000000111111000000011
1000000000000000000001
1000000000000000000001
1000000000000000000001
1000000000000000000001
1000000000000000000001
100000000N000000000001
1000000000000000000001
1000000000000000000001
1111111111111111111111
