1111111111111111111
100000001111110011
111000111    11000011111
1100001011111111111
1000001111111101111111111
10W00001  11    0000000011
11111111111111111111111111