1111111111111111111
1000000000011110011
111000111  1N1000011111
1100001010011111111
100000111000111011
100000S000  11    0000000011
1111111111111111111