NO textures/simonkraft/bookshelf.xpm
SO textures/simonkraft/bookshelf_01.xpm
WE textures/simonkraft/bookshelf_02.xpm
EA textures/simonkraft/bookshelf_03.xpm

F 139,99,58
C 171,154,137

1111111111111111111111
1N00000000111010000011
110100011000111111111
1100001000111000111111
1000000000000000111111
1000000111111000000011
1111111111111111111111
