F 139,99,58
C 171,154,137

NO textures/north.xpm
SO textures/south.xpm
WE textures/west.xpm
EA textures/east.xpm



1111111111111111111111
1N0000000000000000011
1101000111111100000111
110000101   100111000111111
100000001   110000000111111
1000000111111000000011
1111111111111111111111
